%%%%%%%%%%%%%%%%%%%%
%        T         %
%                  %
%       %%%%       %
%                  %
%                  %
%                  %
%                  %
%                  %
%                  %
%                  %
%                  %
%                  %
%                  %
%                  %
%                  %
%                  %
%                  %
%                  %
%       %%%%       %
%                  %
%         P        %
%%%%%%%%%%%%%%%%%%%%
