%%%%%%%%%%%%%%%%%%%%
%      T           %
%                  %
%                  %
%                  %
%                  %
%                  %
%                  %
%                  %
%                  %
%                  %
%                  %
%                  %
%                  %
%                  %
%                  %
%                  %
%                  %
%                  %
%                  %
%                  %
%           C      %
%%%%%%%%%%%%%%%%%%%%
