%%%%%%%%%%%%%%%%%%%%
%        T         %
%                  %
%       %%%%       %
%                  %
%                  %
%                  %
%                  %
%                  %
%                  %
%                  %
%                  %
%                  %
%                  %
%                  %
%                  %
%                  %
%                  %
%                  %
%       %%%%       %
%                  %
%         C        %
%%%%%%%%%%%%%%%%%%%%
